WLWWWWWWWLW
WFFWWFWWFFW
WFFWWSWWFFW
WFFFFFFFFFW
WFFFFFFFFFW
WFFFFFFFFFW
WFFFFFFFFFW
WFFFFFFFFFW
WFFFFFFFFFW
WFFFFFFFFFW
WWWWWWWWWWW